11 12
|---------|
|FFF.|...P|
|F--...--.|
|.-.....-.|
|.-.---.-.|
|....P....|
|.-.---.-.|
|.-.....-.|
|.--...--.|
|P...|...@|
|---------|
